.. _a10_cgnv6_map_encapsulation_fragmentation_inbound_module:


a10_cgnv6_map_encapsulation_fragmentation_inbound -- Configures A10 cgnv6.map.encapsulation.fragmentation.inbound
=================================================================================================================

.. contents::
   :local:
   :depth: 1


Synopsis
--------

MAP-E fragmentation rules for inbound oversize packets






Parameters
----------

+-----------------------+-------------------------------+--------------------------------------------------------------------------------------------------------------------------------------------------------------------------------------------------------------------+
| Parameters            | Choices/Defaults              | Comment                                                                                                                                                                                                            |
|                       |                               |                                                                                                                                                                                                                    |
|                       |                               |                                                                                                                                                                                                                    |
+=======================+===============================+====================================================================================================================================================================================================================+
| state                 | ['noop', 'present', 'absent'] | State of the object to be created.                                                                                                                                                                                 |
|                       |                               |                                                                                                                                                                                                                    |
| str/required          |                               |                                                                                                                                                                                                                    |
+-----------------------+-------------------------------+--------------------------------------------------------------------------------------------------------------------------------------------------------------------------------------------------------------------+
| ansible_host          |                               | Host for AXAPI authentication                                                                                                                                                                                      |
|                       |                               |                                                                                                                                                                                                                    |
| str/required          |                               |                                                                                                                                                                                                                    |
+-----------------------+-------------------------------+--------------------------------------------------------------------------------------------------------------------------------------------------------------------------------------------------------------------+
| ansible_username      |                               | Username for AXAPI authentication                                                                                                                                                                                  |
|                       |                               |                                                                                                                                                                                                                    |
| str/required          |                               |                                                                                                                                                                                                                    |
+-----------------------+-------------------------------+--------------------------------------------------------------------------------------------------------------------------------------------------------------------------------------------------------------------+
| ansible_password      |                               | Password for AXAPI authentication                                                                                                                                                                                  |
|                       |                               |                                                                                                                                                                                                                    |
| str/required          |                               |                                                                                                                                                                                                                    |
+-----------------------+-------------------------------+--------------------------------------------------------------------------------------------------------------------------------------------------------------------------------------------------------------------+
| ansible_port          |                               | Port for AXAPI authentication                                                                                                                                                                                      |
|                       |                               |                                                                                                                                                                                                                    |
| int/required          |                               |                                                                                                                                                                                                                    |
+-----------------------+-------------------------------+--------------------------------------------------------------------------------------------------------------------------------------------------------------------------------------------------------------------+
| a10_device_context_id | ['1-8']                       | Device ID for aVCS configuration                                                                                                                                                                                   |
|                       |                               |                                                                                                                                                                                                                    |
| int                   |                               |                                                                                                                                                                                                                    |
+-----------------------+-------------------------------+--------------------------------------------------------------------------------------------------------------------------------------------------------------------------------------------------------------------+
| a10_partition         |                               | Destination/target partition for object/command                                                                                                                                                                    |
|                       |                               |                                                                                                                                                                                                                    |
| str                   |                               |                                                                                                                                                                                                                    |
+-----------------------+-------------------------------+--------------------------------------------------------------------------------------------------------------------------------------------------------------------------------------------------------------------+
| df_set                |                               | 'drop'= Drop Silently; 'ipv4'= Use IPv4 fragmentation for oversize packets; 'ipv6'= Use IPv6 fragmentation for oversize packets; 'send-icmp'= Send ICMP Type 3 Code 4 (Fragmentation Needed and DF Set) (default); |
|                       |                               |                                                                                                                                                                                                                    |
| str                   |                               |                                                                                                                                                                                                                    |
+-----------------------+-------------------------------+--------------------------------------------------------------------------------------------------------------------------------------------------------------------------------------------------------------------+
| frag_action           |                               | 'drop'= Drop Silently; 'ipv4'= Use IPv4 fragmentation for oversize packets; 'ipv6'= Use IPv6 fragmentation for oversize packets (default);                                                                         |
|                       |                               |                                                                                                                                                                                                                    |
| str                   |                               |                                                                                                                                                                                                                    |
+-----------------------+-------------------------------+--------------------------------------------------------------------------------------------------------------------------------------------------------------------------------------------------------------------+
| uuid                  |                               | uuid of the object                                                                                                                                                                                                 |
|                       |                               |                                                                                                                                                                                                                    |
| str                   |                               |                                                                                                                                                                                                                    |
+-----------------------+-------------------------------+--------------------------------------------------------------------------------------------------------------------------------------------------------------------------------------------------------------------+







Examples
--------

.. code-block:: yaml+jinja

    





Status
------




- This module is not guaranteed to have a backwards compatible interface. *[preview]*


- This module is maintained by community.



Authors
~~~~~~~

- A10 Networks 2018

