.. _a10_logging_email_level_module:


a10_logging_email_level -- Configures A10 logging.email.level
=============================================================

.. contents::
   :local:
   :depth: 1


Synopsis
--------

Set logging level which sent to email address






Parameters
----------

+-----------------------+-------------------------------+--------------------------------------------------------------------------------------------------------------------------------------------------------------------------------------------------------------------------------------------------------------------------------------+
| Parameters            | Choices/Defaults              | Comment                                                                                                                                                                                                                                                                              |
|                       |                               |                                                                                                                                                                                                                                                                                      |
|                       |                               |                                                                                                                                                                                                                                                                                      |
+=======================+===============================+======================================================================================================================================================================================================================================================================================+
| state                 | ['noop', 'present', 'absent'] | State of the object to be created.                                                                                                                                                                                                                                                   |
|                       |                               |                                                                                                                                                                                                                                                                                      |
| str/required          |                               |                                                                                                                                                                                                                                                                                      |
+-----------------------+-------------------------------+--------------------------------------------------------------------------------------------------------------------------------------------------------------------------------------------------------------------------------------------------------------------------------------+
| ansible_host          |                               | Host for AXAPI authentication                                                                                                                                                                                                                                                        |
|                       |                               |                                                                                                                                                                                                                                                                                      |
| str/required          |                               |                                                                                                                                                                                                                                                                                      |
+-----------------------+-------------------------------+--------------------------------------------------------------------------------------------------------------------------------------------------------------------------------------------------------------------------------------------------------------------------------------+
| ansible_username      |                               | Username for AXAPI authentication                                                                                                                                                                                                                                                    |
|                       |                               |                                                                                                                                                                                                                                                                                      |
| str/required          |                               |                                                                                                                                                                                                                                                                                      |
+-----------------------+-------------------------------+--------------------------------------------------------------------------------------------------------------------------------------------------------------------------------------------------------------------------------------------------------------------------------------+
| ansible_password      |                               | Password for AXAPI authentication                                                                                                                                                                                                                                                    |
|                       |                               |                                                                                                                                                                                                                                                                                      |
| str/required          |                               |                                                                                                                                                                                                                                                                                      |
+-----------------------+-------------------------------+--------------------------------------------------------------------------------------------------------------------------------------------------------------------------------------------------------------------------------------------------------------------------------------+
| ansible_port          |                               | Port for AXAPI authentication                                                                                                                                                                                                                                                        |
|                       |                               |                                                                                                                                                                                                                                                                                      |
| int/required          |                               |                                                                                                                                                                                                                                                                                      |
+-----------------------+-------------------------------+--------------------------------------------------------------------------------------------------------------------------------------------------------------------------------------------------------------------------------------------------------------------------------------+
| a10_device_context_id | ['1-8']                       | Device ID for aVCS configuration                                                                                                                                                                                                                                                     |
|                       |                               |                                                                                                                                                                                                                                                                                      |
| int                   |                               |                                                                                                                                                                                                                                                                                      |
+-----------------------+-------------------------------+--------------------------------------------------------------------------------------------------------------------------------------------------------------------------------------------------------------------------------------------------------------------------------------+
| a10_partition         |                               | Destination/target partition for object/command                                                                                                                                                                                                                                      |
|                       |                               |                                                                                                                                                                                                                                                                                      |
| str                   |                               |                                                                                                                                                                                                                                                                                      |
+-----------------------+-------------------------------+--------------------------------------------------------------------------------------------------------------------------------------------------------------------------------------------------------------------------------------------------------------------------------------+
| email_levelname       |                               | 'disable'= Do not send log to email address; 'emergency'= System unusable log messages      (severity=0); 'alert'= Action must be taken immediately (severity=1); 'critical'= Critical conditions      (severity=2); 'notification'= Normal but significant conditions (severity=5); |
|                       |                               |                                                                                                                                                                                                                                                                                      |
| str                   |                               |                                                                                                                                                                                                                                                                                      |
+-----------------------+-------------------------------+--------------------------------------------------------------------------------------------------------------------------------------------------------------------------------------------------------------------------------------------------------------------------------------+
| uuid                  |                               | uuid of the object                                                                                                                                                                                                                                                                   |
|                       |                               |                                                                                                                                                                                                                                                                                      |
| str                   |                               |                                                                                                                                                                                                                                                                                      |
+-----------------------+-------------------------------+--------------------------------------------------------------------------------------------------------------------------------------------------------------------------------------------------------------------------------------------------------------------------------------+







Examples
--------

.. code-block:: yaml+jinja

    





Status
------




- This module is not guaranteed to have a backwards compatible interface. *[preview]*


- This module is maintained by community.



Authors
~~~~~~~

- A10 Networks 2018

